#############################
#        テストケース         #
#############################

# 単純な重複
奇数: jī/shù
奇数: jī/shù

# 他のパターンに影響するテスト
阿谀
萝卜
的确
强人
空洞
空子
累累 -> 罪行累累 こっちを残す
漂白
漂亮
扫帚
高兴
要不
着手 -> 背着手 両方 とも残す
轴子 -> 大轴子 压轴子 とも残す

# 不要、削除した
# 単語中に複数の文字が存在するテスト
颤颤巍巍: chàn/chàn/wēi/wēi
臭烘烘: chòu/hōng/hōng
臭乎乎: chòu/hū/hū
无色无臭: wú/sè/wú/xiù
一唱一和: yī/chàng/yī/hè
间作离间: jiàn/zuò/lí/jiàn
乐呵呵: lè/hē/hē
累累: lěi/lèi
血淋淋: xiě/lín/lín
载歌载舞: zài/gē/zài/wǔ
兴兴头头: xīng/xìng/tou/tóu

# 多音字が複数あるテスト
占卜: zhān/bǔ
 占: zhàn -> zhān
　卜: bo -> bǔ
刨子: bào/zǐ
 刨: páo -> bào
　子: zi -> zǐ
参差: cēn/cī
 参: cān -> cēn
　差: chà -> cī
朝日: zhāo/rì 
 朝: cháo -> zhāo
　日: rì -> rì 
乳臭未干: rǔ/xiù/wèi/gān
 臭: chòu -> xiù
　干: gàn -> gān
处分: chǔ/fèn
 处: chù -> chǔ
　分: fēn -> fèn
调处: tiáo/chǔ
 调: diào -> tiáo
　处: chù -> chǔ　
挣揣: zhèng/chuài
 挣: zhēng -> zhèng
 揣: chuāi -> chuài
囊揣: nāng/chuài
 囊: náng -> nāng
　揣: chuāi -> chuài
少不更事: shào/bù/gēng/shì
 少: shǎo -> shào
　更: gèng -> gēng
勾当: gòu/dàng
 勾: gōu -> gòu
　当: dāng -> dàng
结实: jiē/shi
 结: jié -> jiē
　实: shí -> shi
禁得起: jīn/de/qǐ
 禁: jìn -> jīn
　得: dé -> de
禁不住: jīn/bú/zhù
 禁: jìn -> jīn
　不: bù -> bú
地壳: dì/qiào
 地: de -> dì
　壳: ké -> qiào
乐曲: yuè/qǔ
 乐: lè -> yuè
　曲: qū -> qǔ
漂泊: piāo/bó
 漂: piào -> piāo
　泊: pō -> bó
翘棱: qiáo/lēng
 翘: qiào -> qiáo
　棱: léng -> lēng
切削: qiē/xiāo
 切: qiè -> qiē
　削: xuē -> xiāo
数得着: shǔ/de/zháo
 数: shù -> shǔ
　得: dé -> de
　着: zhe -> zháo
踏实: tā/shi
 踏: tà -> tā
　实: shí -> shi
帖子: tiě/zǐ
 帖: tiē -> tiě
　子: zi -> zǐ
吐血: tù/xiě
 吐: tǔ -> tù
　血: xuè -> xiě
相声: xiàng/sheng
 相: xiāng -> xiàng
　声: shēng -> sheng
相片: xiàng/piān
 相: xiāng -> xiàng
　片: piàn -> piān
血晕: xiě/yùn
 血: xuè -> xiě
　晕: yūn -> yùn
应和: yìng/hè
 应: yīng -> yìng
　和: hé -> hè
种地: zhòng/dì
 种: zhǒng -> zhòng
　地: de -> dì
大轴子: dà/zhòu/zǐ
 轴: zhóu -> zhòu
　子: zi -> zǐ
压轴子: yā/zhòu/zǐ
 轴: zhóu -> zhòu
　子: zi -> zǐ
作坊: zuō/fang
 作: zuò -> zuō
 坊: fāng -> fang
分子: fèn/zǐ
 分: fēn -> fèn
　子: zi -> zǐ



#############################
#        以下、データ         #
#############################

阿托品: ā/tuō/pǐn
阿谀: ē/yú
胶阿谀: jiāo/ē/yú
阿谀谄媚: ē/yú/chǎn/mèi
背离: bèi/lí
背弃: bēi/qì
背弃: bèi/qì
背书: bèi/shū
背运: bèi/yùn
背后: bèi/hòu
背叛: bèi/pàn
背诵: bèi/sòng
背心: bèi/xīn
背着手: bèi/zhe/shǒu
背地里: bèi/dì/lǐ
背景: bèi/jǐng
背包: bēi/bāo
背带: bēi/dài
背负: bēi/fù
背债: bēi/zhài
奔赴: bēn/fù
奔丧: bēn/sāng
奔袭: bēn/xí
奔泻: bēn/xiè
奔驰: bēn/chí
奔跑: bēn/pǎo
奔腾: bēn/téng
奔放: bēn/fàng
奔流: bēn/liú
奔忙: bēn/máng
奔走: bēn/zǒu
私奔: sī/bēn
奔命: bèn/mìng
投奔: tóu/bèn
别号: bié/hào
别是: bié/shì
别针: bié/zhēn
别致: bié/zhì
辨别: biàn/bié
差别: chā/bié
辞别: cí/bié
个别: gè/bié
各别: gè/bié
判别: pàn/bié
惜别: xī/bié
永别: yǒng/bié
别扭: biè/niǔ
屏除: bǐng/chú
屏弃: bǐng/qì
幕屏障: mù/píng/zhàng
占卜: zhān/bǔ
萝卜: luó/bo
胡萝卜: hú/luó/bo
刨除: páo/chú
刨治: páo/zhì
刨梢: páo/shāo
镑刨: bàng/páo
刨削: páo/xuē
刨冰: bào/bīng
刨床: bào/chuáng
刨刀: bào/dāo
刨花: bào/huā
刨工: bào/gōng
刨子: bào/zǐ
刨花: bào/huā
刨身: bào/shēn
刨头: bào/tóu
刨光: bào/guāng
参拜: cān/bài
参校: cān/jiào
参考: cān/kǎo
参量: cān/liàng
参数: cān/shù
参验: cān/yàn
参谒: cān/yè
参赞: cān/zàn
参半: cān/bàn
参见: cān/jiàn
参看: cān/kàn
参天: cān/tiān
参战: cān/zhàn
参政: cān/zhèng
参观: cān/guān
参加: cān/jiā
参军: cān/jūn
参谋: cān/móu
参与: cān/yù
参阅: cān/yuè
参照: cān/zhào
参拜: cān/bài
参半: cān/bàn
参见: cān/jiàn
参差: cēn/cī
党参: dǎng/shēn
海参: hǎi/shēn
人参: rén/shēn
藏匿: cáng/nì
藏书: cáng/shū
藏拙: cáng/zhuō
暗藏: àn/cáng
保藏: bǎo/cáng
躲藏: duǒ/cáng
库藏: kù/cáng
埋藏: mái/cáng
收藏: shōu/cáng
窝藏: wō/cáng
掩藏: yǎn/cáng
蕴藏: yùn/cáng
珍藏: zhēn/cáng
贮藏: zhù/cáng
捉迷藏: zhuō/mí/cáng
藏蓝: zàng/lán
藏历: zàng/lì
藏族: zàng/zú
藏红花: zàng/hóng/huā
宝藏: bǎo/zàng
曾经: céng/jīng
不曾: bù/céng
未曾: wèi/céng
几曾: jǐ/céng
何曾: hé/céng
曾孙: zēng/sūn
曾祖: zēng/zǔ
曾加: zēng/jiā
曾臣: zēng/chén
曾阴: zēng/yīn
曾翁: zēng/wēng
曾巢: zēng/cháo
曾飔: zēng/sī
曾泉: zēng/quán
曾标: zēng/biāo
差劲: chà/jìn
差额: chā/é
差距: chā/jù
差价: chā/jià
差别: chā/bié
差错: chā/cuò
差异: chā/yì
差数: chā/shù
偏差: piān/chā
误差: wù/chā
逆差: nì/chā
差遣: chāi/qiǎn
差使: chāi/shǐ
差事: chāi/shì
出差: chū/chāi
公差: gōng/chāi
交差: jiāo/chāi
钦差: qīn/chāi
参差: cēn/cī
颤颤巍巍: chàn/chàn/wēi/wēi
颤音: chàn/yīn
颤悠: chàn/yōu
颤栗: zhàn/lì
打颤: dǎ/zhàn
场次: chǎng/cì
场记: chǎng/jì
场景: chǎng/jǐng
场子: chǎng/zi
靶场: bǎ/chǎng
包场: bāo/chǎng
上场: shàng/chǎng
操场: cāo/chǎng
广场: guǎng/chǎng
疆场: jiāng/chǎng
冷场: lěng/chǎng
牧场: mù/chǎng
怯场: qiè/chǎng
沙场: shā/chǎng
现场: xiàn/chǎng
刑场: xíng/chǎng
场院: cháng/yuàn
打场: dǎ/cháng
扬场: yáng/cháng
一场雨: yī/cháng/yǔ
登场: dēng/cháng
长话: cháng/huà
长短: cháng/duǎn
长江: cháng/jiāng
长度: cháng/dù
长老: zhǎng/lǎo
生长: shēng/zhǎng
成长: chéng/zhǎng
班长: bān/zhǎng
连长: lián/zhǎng
家长: jiā/zhǎng
军长: jūn/zhǎng
队长: duì/zhǎng
成长: chéng/zhǎng
朝拜: cháo/bài
朝廷: cháo/tíng
朝政: cháo/zhèng
朝代: cháo/dài
朝鲜族: cháo/xiǎn/zú
王朝: wáng/cháo
朝气: zhāo/qì
朝晖: zhāo/huī
朝露: zhāo/lù
朝夕: zhāo/xī
朝霞: zhāo/xiá
朝阳: zhāo/yáng
朝日: zhāo/rì
称号: chēng/hào
称呼: chēng/hū
称强: chēng/qiáng
称谢: chēng/xiè
称誉: chēng/yù
称赞: chēng/zàn
号称: hào/chēng
简称: jiǎn/chēng
名称: míng/chēng
人称: rén/chēng
通称: tōng/chēng
职称: zhí/chēng
自称: zì/chēng
尊称: zūn/chēng
称心: chèn/xīn
称愿: chèn/yuàn
称职: chèn/zhí
相称: xiāng/chèn
匀称: yún/chèn
重兵: zhòng/bīng
重创: zhòng/chuāng
重读: zhòng/dú
重办: zhòng/bàn
重担: zhòng/dàn
重地: zhòng/dì
重活: zhòng/huó
重炮: zhòng/pào
重用: zhòng/yòng
重头戏: zhòng/tóu/xì
重版: chóng/bǎn
重婚: chóng/hūn
重孙: chóng/sūn
重围: chóng/wéi
重霄: chóng/xiāo
重演: chóng/yǎn
重阳: chóng/yáng
重奏: chóng/zòu
重复: chóng/fù
重申: chóng/shēn
重新: chóng/xīn
重唱: chóng/chàng
重出: chóng/chū
重合: chóng/hé
双重: shuāng/chóng
臭虫: chòu/chóng
臭骂: chòu/mà
臭氧: chòu/yǎng
臭豆腐: chòu/dòu/fǔ
臭烘烘: chòu/hōng/hōng
臭乎乎: chòu/hū/hū
狐臭: hú/chòu
口臭: kǒu/chòu
腥臭: xīng/chòu
腋臭: yè/chòu
无色无臭: wú/sè/wú/xiù
乳臭未干: rǔ/xiù/wèi/gān
铜臭: tóng/xiù
处女: chǔ/nǚ
处世: chǔ/shì
处暑: chǔ/shǔ
处死: chǔ/sǐ
处治: chǔ/zhì
处方: chǔ/fāng
处分: chǔ/fèn
处境: chǔ/jìng
处刑: chǔ/xíng
处罚: chǔ/fá
处决: chǔ/jué
处于: chǔ/yú
处置: chǔ/zhì
处理品: chǔ/lǐ/pǐn
难处: nán/chǔ
调处: tiáo/chǔ
相处: xiāng/chǔ
处事: chǔ/shì
处所: chù/suǒ
长处: cháng/chù
害处: hài/chù
益处: yì/chù
家畜: jiā/chù
牲畜: shēng/chù
种畜: zhǒng/chù
畜肥: chù/féi
畜生: chù/shēng
畜牧: xù/mù
畜产品: xù/chǎn/pǐn
揣进: chuāi/jìn
揣测: chuǎi/cè
揣摩: chuǎi/mó
揣想: chuǎi/xiǎng
揣挫: chuǎi/cuò
揣摸: chuǎi/mō
不揣: bù/chuǎi
悬揣: xuán/chuǎi
揣料: chuǎi/liào
挣揣: zhèng/chuài
囊揣: nāng/chuài
传代: chuán/dài
传呼: chuán/hū
传奇: chuán/qí
传讯: chuán/xùn
传达: chuán/dá
传播: chuán/bō
传单: chuán/dān
传递: chuán/dì
传授: chuán/shòu
传统: chuán/tǒng
传送: chuán/sòng
传真: chuán/zhēn
传布: chuán/bù
传导: chuán/dǎo
传动: chuán/dòng
传唤: chuán/huàn
传家: chuán/jiā
传教: chuán/jiào
传令: chuán/lìng
传票: chuán/piào
传情: chuán/qíng
传人: chuán/rén
传神: chuán/shén
传言: chuán/yán
传扬: chuán/yáng
传阅: chuán/yuè
传染病: chuán/rǎn/bìng
失传: shī/chuán
谣传: yáo/chuán
祖传: zǔ/chuán
传略: zhuàn/lüè
传记: zhuàn/jì
评传: píng/zhuàn
自传: zì/zhuàn
创刊: chuàng/kān
创办: chuàng/bàn
创业: chuàng/yè
创制: chuàng/zhì
创见: chuàng/jiàn
创举: chuàng/jǔ
创作: chuàng/zuò
创立: chuàng/lì
创新: chuàng/xīn
创造: chuàng/zào
创设: chuàng/shè
创始: chuàng/shǐ
首创: shǒu/chuàng
创痕: chuāng/hén
创伤: chuāng/shāng
创面: chuāng/miàn
重创: zhòng/chuāng
答案: dá/àn
答辩: dá/biàn
答复: dá/fù
回答: huí/dá
问答: wèn/dá
答理: dā/lǐ
答腔: dā/qiāng
期待: qī/dài
等待: děng/dài
担待: dān/dài
待不住: dāi/bù/zhù
担当: dān/dāng
担架: dān/jià
担名: dān/míng
担子: dàn/zi
弹弓: dàn/gōng
弹片: dàn/piàn
弹丸: dàn/wán
弹药: dàn/yào
弹道: dàn/dào
弹壳: dàn/ké
弹坑: dàn/kēng
弹头: dàn/tóu
枪弹: qiāng/dàn
子弹: zǐ/dàn
弹词: tán/cí
弹劾: tán/hé
弹力: tán/lì
弹性: tán/xìng
弹簧: tán/huáng
弹射: tán/shè
弹指: tán/zhǐ
评弹: píng/tán
当差: dāng/chāi
当场: dāng/chǎng
当代: dāng/dài
当归: dāng/guī
当局: dāng/jú
当然: dāng/rán
当先: dāng/xiān
当道: dāng/dào
当日: dāng/rì
当即: dāng/jí
当空: dāng/kōng
当啷: dāng/lāng
当权: dāng/quán
当下: dāng/xià
当初: dāng/chū
当代: dāng/dài
当地: dāng/dì
当众: dāng/zhòng
当家: dāng/jiā
当局: dāng/jú
当时: dāng/shí
当事人: dāng/shì/rén
当天: dàng/tiān
当年: dàng/nián
当票: dàng/piào
当铺: dàng/pù
当真: dàng/zhēn
当做: dàng/zuò
得当: dé/dàng
失当: shī/dàng
倒把: dǎo/bǎ
倒班: dǎo/bān
倒戈: dǎo/gē
倒换: dǎo/huàn
倒手: dǎo/shǒu
倒塌: dǎo/tā
倒替: dǎo/tì
倒运: dǎo/yùn
打倒: dǎ/dǎo
颠倒: diān/dǎo
倒彩: dào/cǎi
倒车: dào/chē
倒刺: dào/cì
倒立: dào/lì
倒流: dào/liú
倒叙: dào/xù
倒悬: dào/xuán
倒影: dào/yǐng
倒置: dào/zhì
倒转: dào/zhuǎn
倒栽葱: dào/zāi/cōng
似的: shì/de
是的: shì/de
有的是: yǒu/de/shì
的确: dí/què
的确良: dí/què/liáng
目的: mù/dì
得逞: dé/chěng
得当: dé/dàng
得胜: dé/shèng
得失: dé/shī
得手: dé/shǒu
靠得住: kào/de/zhù
晓得: xiǎo/de
认得: rèn/de
懂得: dǒng/de
赢得: yíng/de
值得: zhí/de
调集: diào/jí
调查: diào/chá
调动: diào/dòng
调度: diào/dù
调号: diào/hào
调配: diào/pèi
调用: diào/yòng
调运: diào/yùn
调值: diào/zhí
调令: diào/lìng
调遣: diào/qiǎn
调任: diào/rèn
调子: diào/zi
笔调: bǐ/diào
抽调: chōu/diào
对调: duì/diào
基调: jī/diào
滥调: làn/diào
强调: qiáng/diào
曲调: qǔ/diào
调处: tiáo/chǔ
调羹: tiáo/gēng
调侃: tiáo/kǎn
调教: tiáo/jiào
调理: tiáo/lǐ
调料: tiáo/liào
调情: tiáo/qíng
调停: tiáo/tíng
调戏: tiáo/xì
调味: tiáo/wèi
调笑: tiáo/xiào
调唆: tiáo/suō
调养: tiáo/yǎng
烹调: pēng/tiáo
失调: shī/tiáo
协调: xié/tiáo
空调: kōng/tiáo
都来: dōu/lái
全都: quán/dōu
都城: dū/chéng
都市: dū/shì
首都: shǒu/dū
古都: gǔ/dū
定都: dìng/dū
旧都: jiù/dū
故都: gù/dū
酆都: fēng/dū
奠都: diàn/dū
恶毒: è/dú
恶化: è/huà
恶劣: è/liè
恶习: è/xí
恶性: è/xìng
恶意: è/yì
恶作剧: è/zuò/jù
丑恶: chǒu/è
险恶: xiǎn/è
凶恶: xiōng/è
罪恶: zuì/è
恶心: ě/xīn
可恶: kě/wù
分辨: fēn/biàn
分辩: fēn/biàn
分割: fēn/gē
分泌: fēn/mì
分期: fēn/qī
分布: fēn/bù
分寸: fēn/cùn
分队: fēn/duì
分工: fēn/gōng
分红: fēn/hóng
分化: fēn/huà
分解: fēn/jiě
分离: fēn/lí
分裂: fēn/liè
分明: fēn/míng
分母: fēn/mǔ
分配: fēn/pèi
分批: fēn/pī
分歧: fēn/qí
分清: fēn/qīng
分数: fēn/shù
分析: fēn/xī
分钟: fēn/zhōng
分贝: fēn/bèi
分册: fēn/cè
分担: fēn/dān
分店: fēn/diàn
分居: fēn/jū
分句: fēn/jù
分开: fēn/kāi
分娩: fēn/miǎn
分秒: fēn/miǎo
分蘖: fēn/niè
分设: fēn/shè
分身: fēn/shēn
分手: fēn/shǒu
分头: fēn/tóu
分晓: fēn/xiǎo
分赃: fēn/zāng
分支: fēn/zhī
春分: chūn/fēn
瓜分: guā/fēn
平分: píng/fēn
区分: qū/fēn
分量: fèn/liàng
分外: fèn/wài
安分: ān/fèn
处分: chǔ/fèn
过分: guò/fèn
情分: qíng/fèn
缘分: yuán/fèn
成分: chéng/fèn
身分: shēn/fèn
缝隙: fèng/xì
缝子: fèng/zi
缝缀: féng/zhuì
弥缝: mí/féng
裁缝: cái/féng
缝补: féng/bǔ
缝合: féng/hé
缝纫: féng/rèn
干巴: gān/bā
干杯: gān/bēi
干瘪: gān/biě
干戈: gān/gē
干扰: gān/rǎo
干涉: gān/shè
干系: gān/xì
干燥: gān/zào
干支: gān/zhī
风干: fēng/gān
若干: ruò/gān
相干: xiāng/gān
香干: xiāng/gān
干部: gàn/bù
干劲: gàn/jìn
干将: gàn/jiàng
干练: gàn/liàn
干流: gàn/liú
干事: gàn/shì
干线: gàn/xiàn
才干: cái/gàn
骨干: gǔ/gàn
蛮干: mán/gàn
能干: néng/gàn
主干: zhǔ/gàn
更加: gèng/jiā
更好: gèng/hǎo
更其: gèng/qí
更动: gēng/dòng
更迭: gēng/dié
更改: gēng/gǎi
更番: gēng/fān
更次: gēng/cì
更换: gēng/huàn
更生: gēng/shēng
更新: gēng/xīn
更衣: gēng/yī
更易: gēng/yì
更正: gēng/zhèng
更定: gēng/dìng
起更: qǐ/gēng
打更: dǎ/gēng
五更: wǔ/gēng
少不更事: shào/bù/gēng/shì
供给: gōng/jǐ
供应: gōng/yìng
供养: gòng/yǎng
自供: zì/gòng
勾结: gōu/jié
勾搭: gōu/dā
勾画: gōu/huà
沟通: gōu/tōng
勾销: gōu/xiāo
勾引: gōu/yǐn
勾当: gòu/dàng
行程: xíng/chéng
行刺: xíng/cì
行贿: xíng/huì
行军: xíng/jūn
行李: xíng/lǐ
行径: xíng/jìng
行人: xíng/rén
行宫: xíng/gōng
行乐: xíng/lè
行期: xíng/qī
行善: xíng/shàn
行事: xíng/shì
行文: xíng/wén
行刑: xíng/xíng
行医: xíng/yī
行走: xíng/zǒu
行装: xíng/zhuāng
行乞: xíng/qǐ
行使: xíng/shǐ
行署: xíng/shǔ
行为: xíng/wéi
行政: xíng/zhèng
行踪: xíng/zōng
暴行: bào/xíng
德行: dé/xíng
横行: héng/xíng
刊行: kān/xíng
盛行: shèng/xíng
运行: yùn/xíng
行车: xíng/chē
行当: háng/dāng
行家: háng/jiā
行间: háng/jiān
行列: háng/liè
行情: háng/qíng
行业: háng/yè
发行: fā/háng
同行: tóng/háng
外行: wài/háng
银行: yín/háng
行话: háng/huà
行会: háng/huì
行距: háng/jù
树行子: shù/hàng/zi
道行: dào/héng
好歹: hǎo/dǎi
好汉: hǎo/hàn
好受: hǎo/shòu
好意: hǎo/yì
友好: yǒu/hǎo
好赖: hǎo/lài
好听: hǎo/tīng
好人: hǎo/rén
好事: hǎo/shì
好手: hǎo/shǒu
好像: hǎo/xiàng
好似: hǎo/sì
好笑: hǎo/xiào
好心: hǎo/xīn
好些: hǎo/xiē
好比: hǎo/bǐ
好吃: hǎo/chī
好处: hǎo/chù
好在: hǎo/zài
好多: hǎo/duō
好咸: hǎo/xián
好坏: hǎo/huài
好久: hǎo/jiǔ
好说: hǎo/shuō
美好: měi/hǎo
恰好: qià/hǎo
好强: hào/qiáng
好客: hào/kè
好奇: hào/qí
好胜: hào/shèng
爱好: ài/hào
好看: hào/kàn
号称: hào/chēng
号角: hào/jiǎo
号码: hào/mǎ
号外: hào/wài
号兵: hào/bīng
号令: hào/lìng
号召: hào/zhào
编号: biān/hào
等号: děng/hào
挂号: guà/hào
信号: xìn/hào
病号: bìng/hào
号哭: háo/kū
号啕: háo/táo
和蔼: hé/ǎi
和睦: hé/mù
和平: hé/píng
和尚: hé/shàng
和谐: hé/xié
和煦: hé/xù
和风: hé/fēng
和好: hé/hǎo
和缓: hé/huǎn
和局: hé/jú
和善: hé/shàn
和声: hé/shēng
和数: hé/shù
和解: hé/jiě
和谈: hé/tán
和约: hé/yuē
人和: rén/hé
温和: wēn/hé
说和: shuō/hé
搅和: jiǎo/huo
暖和: nuǎn/huo
热和: rè/huo
软和: ruǎn/huo
一唱一和: yī/chàng/yī/hè
和牌: hú/pái
和面: huó/miàn
和泥: huó/ní
和稀泥: huò/xī/ní
横渡: héng/dù
横幅: héng/fú
横贯: héng/guàn
横眉: héng/méi
横批: héng/pī
横扫: héng/sǎo
横竖: héng/shù
横财: hèng/cái
横祸: hèng/huò
骄横: jiāo/hèng
蛮横: mán/hèng
凶横: xiōng/hèng
专横: zhuān/hèng
哄然: hōng/rán
哄抬: hōng/tái
哄堂: hōng/táng
哄骗: hǒng/piàn
起哄: qǐ/hòng
一哄而散: yī/hòng/ér/sàn
还有: hái/yǒu
还是: hái/shì
还书: huán/shū
还本: huán/běn
还账: huán/zhàng
还击: huán/jī
还手: huán/shǒu
还席: huán/xí
还债: huán/zhài
还口: huán/kǒu
还价: huán/jià
还礼: huán/lǐ
还原: huán/yuán
还嘴: huán/zuǐ
回还: huí/huán
发还: fā/huán
放还: fàng/huán
往还: wǎng/huán
偿还: cháng/huán
奉还: fèng/huán
生还: shēng/huán
退还: tuì/huán
送还: sòng/huán
豁口: huō/kǒu
豁出去: huō/chū/qù
豁达: huò/dá
豁亮: huò/liàng
豁免: huò/miǎn
豁然: huò/rán
假扮: jiǎ/bàn
假借: jiǎ/jiè
假冒: jiǎ/mào
假设: jiǎ/shè
假释: jiǎ/shì
假定: jiǎ/dìng
假如: jiǎ/rú
假若: jiǎ/ruò
假使: jiǎ/shǐ
假充: jiǎ/chōng
假山: jiǎ/shān
假死: jiǎ/sǐ
假托: jiǎ/tuō
假意: jiǎ/yì
假象: jiǎ/xiàng
假造: jiǎ/zào
假装: jiǎ/zhuāng
搀假: chān/jiǎ
虚假: xū/jiǎ
作假: zuò/jiǎ
假期: jià/qī
假条: jià/tiáo
假日: jià/rì
病假: bìng/jià
请假: qǐng/jià
间架: jiān/jià
车间: chē/jiān
房间: fáng/jiān
民间: mín/jiān
期间: qī/jiān
时间: shí/jiān
间谍: jiàn/dié
间断: jiàn/duàn
间隔: jiàn/gé
间接: jiàn/jiē
间苗: jiàn/miáo
间隙: jiàn/xì
间歇: jiàn/xiē
间作离间: jiàn/zuò/lí/jiàn
相间: xiāng/jiàn
降级: jiàng/jí
降落: jiàng/luò
降温: jiàng/wēn
降格: jiàng/gé
降生: jiàng/shēng
降水: jiàng/shuǐ
降低: jiàng/dī
降价: jiàng/jià
下降: xià/jiàng
空降: kōng/jiàng
降伏: xiáng/fú
降服: xiáng/fú
降顺: xiáng/shùn
投降: tóu/xiáng
劝降: quàn/xiáng
诱降: yòu/xiáng
招降: zhāo/xiáng
强暴: qiáng/bào
强度: qiáng/dù
强占: qiáng/zhàn
强攻: qiáng/gōng
强占: qiáng/zhàn
加强: jiā/qiáng
强奸: qiáng/jiān
强健: qiáng/jiàn
强劲: qiáng/jìng
强项: qiáng/xiàng
强行: qiáng/xíng
强硬: qiáng/yìng
强占: qiáng/zhàn
强壮: qiáng/zhuàng
强盗: qiáng/dào
强权: qiáng/quán
强制: qiáng/zhì
强盛: qiáng/shèng
强烈: qiáng/liè
强化: qiáng/huà
强调: qiáng/diào
强大: qiáng/dà
强嘴: jiàng/zuǐ
倔强: jué/jiàng
强求: qiǎng/qiú
强人: qiǎng/rén
强迫: qiǎng/pò
强辩: qiǎng/biàn
强词夺理: qiǎng/cí/duó/lǐ
强人所难: qiǎng/rén/suǒ/nán
强颜欢笑: qiǎng/yán/huān/xiào
教导: jiào/dǎo
教会: jiào/huì
教练: jiào/liàn
教师: jiào/shī
教唆: jiào/suō
教训: jiào/xùn
教育: jiào/yù
教材: jiào/cái
教室: jiào/shì
教堂: jiào/táng
教条: jiào/tiáo
教员: jiào/yuán
教书: jiāo/shū
教学: jiāo/xué
角度: jiǎo/dù
角落: jiǎo/luò
角斗: jué/dòu
角色: jué/sè
角逐: jué/zhú
将近: jiāng/jìn
将军: jiāng/jūn
将来: jiāng/lái
将要: jiāng/yào
将官: jiàng/guān
将领: jiàng/lǐng
校风: xiào/fēng
校官: xiào/guān
校规: xiào/guī
校刊: xiào/kān
校徽: xiào/huī
校园: xiào/yuán
校长: xiào/zhǎng
校点: jiào/diǎn
校订: jiào/dìng
校对: jiào/duì
校改: jiào/gǎi
校勘: jiào/kān
校样: jiào/yàng
校阅: jiào/yuè
校正: jiào/zhèng
校准: jiào/zhǔn
结案: jié/àn
结构: jié/gòu
结合: jié/hé
结核: jié/hé
结婚: jié/hūn
结晶: jié/jīng
结局: jié/jú
结论: jié/lùn
结业: jié/yè
结肠: jié/cháng
结存: jié/cún
结交: jié/jiāo
结膜: jié/mó
结石: jié/shí
结义: jié/yì
结余: jié/yú
结怨: jié/yuàn
结扎: jié/zā
结盟: jié/méng
结帐: jié/zhàng
结识: jié/shí
结束: jié/shù
结算: jié/suàn
结业: jié/yè
勾结: gōu/jié
喉结: hóu/jié
团结: tuán/jié
总结: zǒng/jié
结果: jiē/guǒ
结实: jiē/shi
巴结: bā/jie
尽先: jǐn/xiān
尽管: jǐn/guǎn
尽量: jǐn/liàng
尽早: jǐn/zǎo
尽自: jǐn/zì
尽力: jìn/lì
尽情: jìn/qíng
尽头: jìn/tóu
尽兴: jìn/xìng
尽职: jìn/zhí
尽忠: jìn/zhōng
禁闭: jìn/bì
禁地: jìn/dì
禁锢: jìn/gù
禁忌: jìn/jì
禁绝: jìn/jué
禁区: jìn/qū
禁止: jìn/zhǐ
禁令: jìn/lìng
查禁: chá/jìn
监禁: jiān/jìn
拘禁: jū/jìn
囚禁: qiú/jìn
违禁: wéi/jìn
禁受: jīn/shòu
禁得起: jīn/de/qǐ
禁不住: jīn/bú/zhù
看病: kàn/bìng
看破: kàn/pò
看望: kàn/wàng
看相: kàn/xiàng
看待: kàn/dài
看法: kàn/fǎ
看见: kàn/jiàn
看来: kàn/lái
看重: kàn/zhòng
看透: kàn/tòu
看齐: kàn/qí
看轻: kàn/qīng
看台: kàn/tái
看作: kàn/zuò
参看: cān/kàn
查看: chá/kàn
难看: nán/kàn
小看: xiǎo/kàn
看管: kān/guǎn
看护: kān/hù
看家: kān/jiā
看守: kān/shǒu
看押: kān/yā
弹壳: dàn/ké
地壳: dì/qiào
甲壳: jiǎ/qiào
躯壳: qū/qiào
金蝉脱壳: jīn/chán/tuō/qiào
空腹: kōng/fù
空耗: kōng/hào
空降: kōng/jiàng
空论: kōng/lùn
空头: kōng/tóu
空转: kōng/zhuàn
空喊: kōng/hǎn
空际: kōng/jì
空洞: kōng/dòng
空旷: kōng/kuàng
空门: kōng/mén
空勤: kōng/qín
空话: kōng/huà
空谈: kōng/tán
空投: kōng/tóu
空袭: kōng/xí
空运: kōng/yùn
空战: kōng/zhàn
空竹: kōng/zhú
空间: kōng/jiān
空军: kōng/jūn
空气: kōng/qì
空想: kōng/xiǎng
空虚: kōng/xū
空中: kōng/zhōng
空架子: kōng/jià/zi
防空洞: fáng/kōng/dòng
凭空: píng/kōng
扑空: pū/kōng
天空: tiān/kōng
空白: kòng/bái
空儿: kòng/ér
空隙: kòng/xì
空额: kòng/é
空缺: kòng/quē
空暇: kòng/xiá
空闲: kòng/xián
空子: kòng/zi
填空: tián/kòng
偷空: tōu/kòng
乐观: lè/guān
乐趣: lè/qù
乐意: lè/yì
乐于: lè/yú
乐园: lè/yuán
乐呵呵: lè/hē/hē
康乐: kāng/lè
快乐: kuài/lè
欢乐: huān/lè
娱乐: yú/lè
乐池: yuè/chí
乐谱: yuè/pǔ
乐曲: yuè/qǔ
乐器: yuè/qì
乐团: yuè/tuán
乐章: yuè/zhāng
哀乐: āi/yuè
声乐: shēng/yuè
音乐: yīn/yuè
奏乐: zòu/yuè
除了: chú/le
算了: suàn/le
为了: wèi/le
了解: liǎo/jiě
了结: liǎo/jié
了不起: liǎo/bù/qǐ
了不得: liǎo/bù/dé
受不了: shòu/bù/liǎo
私了: sī/liǎo
累次: lěi/cì
累积: lěi/jī
累及: lěi/jí
累进: lěi/jìn
连累: lián/lěi
罪行累累: zuì/xíng/lěi/lèi
累累: léiléi
累赘: léi/zhuì
累进: lèi/jìn
劳累: láo/lèi
累死了: lèi/sǐ/le
太累了: tài/lèi/le
量变: liàng/biàn
量词: liàng/cí
量力: liàng/lì
产量: chǎn/liàng
度量: dù/liàng
气量: qì/liàng
雅量: yǎ/liàng
量杯: liáng/bēi
量度: liáng/dù
量具: liáng/jù
量筒: liáng/tǒng
测量: cè/liáng
估量: gū/liáng
笼子: lóng/zi
笼络: lǒng/luò
笼统: lǒng/tǒng
笼罩: lǒng/zhào
露骨: lù/gǔ
露水: lù/shuǐ
露营: lù/yíng
露珠: lù/zhū
露面: lòu/miàn
露脸: lòu/liǎn
露头: lòu/tóu
露马脚: lòu/mǎ/jiǎo
效率: xiào/lǜ
比率: bǐ/lǜ
率领: shuài/lǐng
坦率: tǎn/shuài
没有: méi/yǒu
没事: méi/shì
没收: mò/shōu
埋没: mái/mò
神出鬼没: shén/chū/guǐ/mò
门票: mén/piào
把门: bǎ/mén
门牙: mén/yá
门口: mén/kǒu
前门: qián/mén
后门: hòu/mén
液门: yè/mén
过门: guò/mén
球门: qiú/mén
名门: míng/mén
阿门: ā/mēn
蒙蔽: méng/bì
蒙混: méng/hùn
蒙昧: méng/mèi
蒙受: méng/shòu
蒙骗: mēng/piàn
蒙古族: měng/gǔ/zú
埋藏: mái/cáng
埋伏: mái/fú
埋葬: mái/zàng
埋怨: mán/yuàn
模拟: mó/nǐ
模式: mó/shì
模范: mó/fàn
模仿: mó/fǎng
模糊: mó/hu
模型: mó/xíng
规模: guī/mó
楷模: kǎi/mó
模样: mú/yàng
宁日: níng/rì
宁静: níng/jìng
宁可: nìng/kě
宁肯: nìng/kěn
宁愿: nìng/yuàn
难产: nán/chǎn
难处: nán/chǔ
难处: nán/chǔ
难点: nán/diǎn
难说: nán/shuō
难为: nán/wéi
难道: nán/dào
难得: nán/de
难度: nán/dù
难怪: nán/guài
难决: nán/jué
难堪: nán/kān
难无: nán/wú
难免: nán/miǎn
难受: nán/shòu
难以: nán/yǐ
难题: nán/tí
难于: nán/yú
艰难: jiān/nán
为难: wéi/nán
疑难: yí/nán
难胞: nàn/bāo
难侨: nàn/qiáo
难友: nàn/yǒu
避难: bì/nàn
非难: fēi/nàn
磨难: mó/nàn
遇难: yù/nàn
困难: kùn/nan
弄鬼: nòng/guǐ
弄权: nòng/quán
摆弄: bǎi/nòng
拨弄: bō/nòng
嘲弄: cháo/nòng
卖弄: mài/nòng
里弄: lǐ/lòng
漂泊: piāo/bó
漂浮: piāo/fú
漂流: piāo/liú
漂移: piāo/yí
漂白: piǎo/bái
漂染: piǎo/rǎn
漂白粉: piǎo/bái/fěn
漂亮: piào/liàng
漂亮话: piào/liàng/huà
悄语: qiāo/yǔ
悄密: qiāo/mì
悄静: qiāo/jìng
悄切: qiāo/qiè
悄孤: qiāo/gū
凄悄: qī/qiāo
洁悄: jié/qiāo
空悄: kōng/qiāo
清悄: qīng/qiāo
悄然: qiǎo/rán
悄寂: qiǎo/jì
悄声: qiǎo/shēng
悄怆: qiǎo/chuàng
翘揭: qiào/jiē
朱翘: zhū/qiào
翘板: qiào/bǎn
翘竦: qiào/sǒng
翘馆: qiào/guǎn
翘拔: qiào/bá
翘过: qiào/guò
翘首: qiáo/shǒu
翘棱: qiáo/lēng
翘企: qiáo/qǐ
翘楚: qiáo/chǔ
连翘: lián/qiáo
翘望: qiáo/wàng
切合: qiè/hé
切记: qiè/jì
切忌: qiè/jì
切脉: qiè/mài
切身: qiè/shēn
切题: qiè/tí
切实: qiè/shí
反切: fǎn/qiè
关切: guān/qiè
恳切: kěn/qiè
密切: mì/qiè
亲切: qīn/qiè
确切: què/qiè
一切: yī/qiè
切除: qiē/chú
切磋: qiē/cuō
切割: qiē/gē
切口: qiē/kǒu
切片: qiē/piàn
切削: qiē/xiāo
切面: qiē/miàn
曲尺: qū/chǐ
曲解: qū/jiě
曲直: qū/zhí
曲折: qū/zhé
曲线: qū/xiàn
曲棍球: qū/gùn/qiú
蜷曲: quán/qū
曲调: qǔ/diào
曲牌: qǔ/pái
曲谱: qǔ/pǔ
曲艺: qǔ/yì
插曲: chā/qǔ
歌曲: gē/qǔ
戏曲: xì/qǔ
组曲: zǔ/qǔ
奏鸣曲: zòu/míng/qǔ
大曲: dà/qǔ
散播: sàn/bō
散场: sàn/chǎng
散落: sàn/luò
散失: sàn/shī
散心: sàn/xīn
散热器: sàn/rè/qì
散步: sàn/bù
散发: sàn/fà
散光: sǎn/guāng
散漫: sǎn/màn
散文: sǎn/wén
散装: sǎn/zhuāng
拆散: chāi/sǎn
懒散: lǎn/sǎn
松散: sōng/sǎn
闲散: xián/sǎn
疏散: shū/sǎn
丧家: sàng/jiā
丧胆: sàng/dǎn
丧命: sàng/mìng
丧偶: sàng/ǒu
丧气: sàng/qì
丧失: sàng/shī
沮丧: jǔ/sàng
沦丧: lún/sàng
颓丧: tuí/sàng
丧服: sāng/fú
丧礼: sāng/lǐ
丧乱: sāng/luàn
丧葬: sāng/zàng
丧钟: sāng/zhōng
吊丧: diào/sāng
治丧: zhì/sāng
扫荡: sǎo/dàng
扫雷: sǎo/léi
扫盲: sǎo/máng
扫地: sǎo/dì
扫房: sǎo/fáng
扫墓: sǎo/mù
扫尾: sǎo/wěi
扫描: sǎo/miáo
扫射: sǎo/shè
扫兴: sǎo/xìng
打扫: dǎ/sǎo
扫帚: sào/zhǒu
扫帚星: sào/zhǒu/xīng
少时候: shǎo/shí/hòu
少女: shào/nǚ
少尉: shào/wèi
少爷: shào/yé
舍下: shè/xià
宿舍: sù/shè
舍命: shě/mìng
舍弃: shě/qì
舍身: shě/shēn
舍不得: shě/bù/dé
施舍: shī/shě
省城: shěng/chéng
俭省: jiǎn/shěng
省事: shěng/shì
省心: shěng/xīn
省份: shěng/fèn
省略号: shěng/lüè/hào
俭省: jiǎn/shěng
节省: jié/shěng
省亲: xǐng/qīn
省悟: xǐng/wù
反省: fǎn/xǐng
数得着: shǔ/de/zháo
数量: shù/liàng
数据: shù/jù
数字: shù/zì
数见不鲜: shuò/jiàn/bù/xiān
似乎: sì/hū
相似: xiāng/sì
似的: shì/de
踏步: tà/bù
踏歌: tà/gē
踏青: tà/qīng
践踏: jiàn/tà
踏实: tā/shi
青苔: qīng/tái
舌苔: shé/tāi
提成: tí/chéng
提花: tí/huā
提琴: tí/qín
提神: tí/shén
提审: tí/shěn
提携: tí/xié
提防: dī/fáng
挑选: tiāo/xuǎn
挑拣: tiāo/jiǎn
挑剔: tiāo/tī
挑眼: tiāo/yǎn
挑子: tiāo/zi
挑拨: tiǎo/bō
挑衅: tiǎo/xìn
挑战: tiǎo/zhàn
挑灯: tiǎo/dēng
挑动: tiǎo/dòng
挑逗: tiǎo/dòu
挑花: tiǎo/huā
挑唆: tiǎo/suō
妥帖: tuǒ/tiē
熨帖: yù/tiē
伏帖: fú/tiē
宁帖: níng/tiē
请帖: qǐng/tiě
帖子: tiě/zǐ
黑帖: hēi/tiě
名帖: míng/tiě
禀帖: bǐng/tiě
庚帖: gēng/tiě
换帖: huàn/tiě
字帖: zì/tiè
临帖: lín/tiè
画帖: huà/tiè
吐蕃: tǔ/bō
吐露: tǔ/lù
吐穗: tǔ/suì
谈吐: tán/tǔ
吞吐: tūn/tǔ
吐沫: tù/mò
吐血: tù/xiě
吐泻: tù/xiè
呕吐: ǒu/tù
拓宽: tuò/kuān
拓拔: tuò/bá
拓落: tuò/luò
拓销: tuò/xiāo
拓展: tuò/zhǎn
拓荒: tuò/huāng
拓殖: tuò/zhí
拓提: tuò/tí
开拓: kāi/tuò
拓本: tà/běn
拓片: tà/piàn
拓手: tà/shǒu
碑拓: bēi/tà
朱拓: zhū/tà
瓦解: wǎ/jiě
瓦工: wǎ/gōng
瓦匠: wǎ/jiàng
瓦砾: wǎ/lì
瓦斯: wǎ/sī
瓦特: wǎ/tè
瓦刀: wà/dāo
为人: wéi/rén
为数: wéi/shù
为难: wéi/nán
为期: wéi/qī
为首: wéi/shǒu
为止: wéi/zhǐ
成为: chéng/wéi
行为: xíng/wéi
以为: yǐ/wéi
作为: zuò/wéi
为何: wèi/hé
为了: wèi/le
为什么: wèi/shén/me
因为: yīn/wèi
华为: huá/wèi
相称: xiāng/chèn
相处: xiāng/chǔ
相传: xiāng/chuán
相比: xiāng/bǐ
相差: xiāng/chà
相当: xiāng/dāng
相等: xiāng/děng
相对: xiāng/duì
相反: xiāng/fǎn
相符: xiāng/fú
相关: xiāng/guān
相互: xiāng/hù
相继: xiāng/jì
相似: xiāng/sì
相交: xiāng/jiāo
相识: xiāng/shí
相同: xiāng/tóng
相通: xiāng/tōng
相仿: xiāng/fǎng
相逢: xiāng/féng
相思: xiāng/sī
相象: xiāng/xiàng
相依: xiāng/yī
相互: xiāng/hù
相公: xiàng/gōng
相机: xiàng/jī
相貌: xiàng/mào
相面: xiàng/miàn
相声: xiàng/sheng
相片: xiàng/piān
扮相: bàn/xiàng
看相: kàn/xiàng
亮相: liàng/xiàng
识相: shí/xiàng
照相: zhào/xiàng
真相: zhēn/xiàng
血管: xuè/guǎn
血压: xuè/yā
血液: xuè/yè
血癌: xuè/ái
血案: xuè/àn
血本: xuè/běn
血崩: xuè/bēng
血沉: xuè/chén
血防: xuè/fáng
血迹: xuè/jì
血浆: xuè/jiāng
血库: xuè/kù
血污: xuè/wū
血泪: xuè/lèi
血脉: xuè/mài
血泊: xuè/pō
血气: xuè/qì
血清: xuè/qīng
血球: xuè/qiú
血肉: xuè/ròu
血色: xuè/sè
血书: xuè/shū
血栓: xuè/shuān
血水: xuè/shuǐ
血糖: xuè/táng
血统: xuè/tǒng
血洗: xuè/xǐ
血象: xuè/xiàng
血腥: xuè/xīng
血型: xuè/xíng
血性: xuè/xìng
血衣: xuè/yī
血缘: xuè/yuán
血债: xuè/zhài
血战: xuè/zhàn
血渍: xuè/zì
血晕: xiě/yùn
血淋淋: xiě/lín/lín
兴办: xīng/bàn
兴奋: xīng/fèn
兴建: xīng/jiàn
兴起: xīng/qǐ
兴旺: xīng/wàng
兴兵: xīng/bīng
兴隆: xīng/lóng
兴盛: xīng/shèng
兴师: xīng/shī
兴衰: xīng/shuāi
兴亡: xīng/wáng
兴修: xīng/xiū
兴许: xīng/xǔ
振兴: zhèn/xīng
复兴: fù/xīng
兴趣: xìng/qù
高兴: gāo/xìng
即兴: jí/xìng
扫兴: sǎo/xìng
雅兴: yǎ/xìng
游兴: yóu/xìng
助兴: zhù/xìng
旋律: xuán/lǜ
旋转: xuán/zhuǎn
旋梯: xuán/tī
旋涡: xuán/wō
回旋: huí/xuán
螺旋: luó/xuán
斡旋: wò/xuán
周旋: zhōu/xuán
旋风: xuàn/fēng
咽喉: yān/hóu
咽头: yān/tóu
咽气: yàn/qì
吞咽: tūn/yàn
呜咽: wū/yè
哽咽: gěng/yè
幽咽: yōu/yè
悲咽: bēi/yè
要不: yào/bù
要冲: yào/chōng
要道: yào/dào
要地: yào/dì
要犯: yào/fàn
要害: yào/hài
要价: yào/jià
要件: yào/jiàn
要略: yào/lüè
要目: yào/mù
要强: yào/qiáng
要人: yào/rén
要塞: yào/sài
要图: yào/tú
要闻: yào/wén
要员: yào/yuán
要职: yào/zhí
要点: yào/diǎn
要领: yào/lǐng
要么: yào/me
要命: yào/mìng
要是: yào/shì
要素: yào/sù
要面子: yào/miàn/zi
要不然: yào/bù/rán
扼要: è/yào
需要: xū/yào
摘要: zhāi/yào
重要: zhòng/yào
要求: yāo/qiú
要挟: yāo/xié
殷切: yīn/qiè
殷勤: yīn/qín
殷实: yīn/shí
殷红: yān/hóng
应当: yīng/dāng
应该: yīng/gāi
应届: yīng/jiè
应声: yīng/shēng
应许: yīng/xǔ
应允: yīng/yǔn
应变: yìng/biàn
应承: yìng/chéng
应酬: yìng/chóu
应答: yìng/dá
应对: yìng/duì
应付: yìng/fù
应和: yìng/hè
应急: yìng/jí
应景: yìng/jǐng
应考: yìng/kǎo
应募: yìng/mù
应诺: yìng/nuò
应试: yìng/shì
应验: yìng/yàn
应用: yìng/yòng
应运: yìng/yùn
应诊: yìng/zhěn
应征: yìng/zhēng
报应: bào/yìng
反应: fǎn/yìng
接应: jiē/yìng
响应: xiǎng/yìng
照应: zhào/yìng
应名儿: yìng/míng/ér
晕厥: yūn/jué
晕车: yùn/chē
晕船: yùn/chuán
月晕: yuè/yùn
载重: zài/zhòng
超载: chāo/zài
承载: chéng/zài
运载: yùn/zài
装载: zhuāng/zài
载歌载舞: zài/gē/zài/wǔ
风雪载途: fēng/xuě/zài/tú
登载: dēng/zǎi
记载: jì/zǎi
刊载: kān/zǎi
连载: lián/zǎi
转载: zhuǎn/zǎi
扎根: zhā/gēn
扎手: zhā/shǒu
扎眼: zhā/yǎn
扎营: zhā/yíng
扎针: zhā/zhēn
挣扎: zhēng/zhá
结扎: jié/zā
穿着: chuān/zhe
跟着: gēn/zhe
看着: kàn/zhe
刻着: kè/zhe
接着: jiē/zhe
沿着: yán/zhe
尽着: jǐn/zhe
挨着: āi/zhe
着急: zháo/jí
着凉: zháo/liáng
着迷: zháo/mí
睡不着: shuì/bù/zháo
没着了: méi/zhāo/le
着陆: zhuó/lù
着手: zhuó/shǒu
执着: zhí/zhuó
沉着: chén/zhuó
着落: zhuó/luò
着笔: zhuó/bǐ
折合: zhé/hé
折磨: zhé/mó
折叠: zhé/dié
折扣: zhé/kòu
折射: zhé/shè
折算: zhé/suàn
折中: zhé/zhōng
波折: bō/zhé
存折: cún/zhé
骨折: gǔ/zhé
曲折: qū/zhé
折腾: zhē/téng
折本: shé/běn
折耗: shé/hào
挣扎: zhēng/zhá
挣命: zhèng/mìng
中餐: zhōng/cān
中断: zhōng/duàn
中坚: zhōng/jiān
中介: zhōng/jiè
中看: zhōng/kàn
中立: zhōng/lì
中班: zhōng/bān
中波: zhōng/bō
中层: zhōng/céng
中东: zhōng/dōng
中队: zhōng/duì
中耳: zhōng/ěr
中路: zhōng/lù
中锋: zhōng/fēng
中伏: zhōng/fú
中古: zhōng/gǔ
中和: zhōng/hé
中华: zhōng/huá
中级: zhōng/jí
中将: zhōng/jiàng
中流: zhōng/liú
中落: zhōng/luò
中期: zhōng/qī
中人: zhōng/rén
中外: zhōng/wài
中西: zhōng/xī
中线: zhōng/xiàn
中叶: zhōng/yè
忠于: zhōng/yú
中止: zhōng/zhǐ
中转: zhōng/zhuǎn
中年: zhōng/nián
中文: zhōng/wén
中式: zhōng/shì
中枢: zhōng/shū
中听: zhōng/tīng
中心: zhōng/xīn
中型: zhōng/xíng
中学: zhōng/xué
中药: zhōng/yào
中庸: zhōng/yōng
中用: zhōng/yòng
中游: zhōng/yóu
中原: zhōng/yuán
适中: shì/zhōng
中毒: zhòng/dú
中风: zhòng/fēng
中奖: zhòng/jiǎng
中肯: zhòng/kěn
中签: zhòng/qiān
中伤: zhòng/shāng
中暑: zhòng/shǔ
中意: zhòng/yì
中选: zhòng/xuǎn
看中: kàn/zhòng
种畜: zhǒng/chù
种类: zhǒng/lèi
种子: zhǒng/zi
种族: zhǒng/zú
播种: bō/zhǒng
剧种: jù/zhǒng
育种: yù/zhǒng
种痘: zhòng/dòu
种地: zhòng/dì
种花: zhòng/huā
种田: zhòng/tián
种植: zhòng/zhí
栽种: zāi/zhòng
耕种: gēng/zhòng
轴承: zhóu/chéng
轴心: zhóu/xīn
轴子: zhóu/zǐ
车轴: chē/zhóu
画轴: huà/zhóu
大轴子: dà/zhòu/zi
压轴子: yā/zhòu/zi
转播: zhuǎn/bō
转变: zhuǎn/biàn
转车: zhuǎn/chē
转达: zhuǎn/dá
转关系: zhuǎn/guān/xì
逆转: nì/zhuǎn
旋转: xuán/zhuǎn
周转: zhōu/zhuǎn
转动: zhuàn/dòng
转盘: zhuàn/pán
转椅: zhuàn/yǐ
转悠: zhuàn/yōu
转轴: zhuàn/zhóu
自转: zì/zhuàn
钻探: zuān/tàn
钻营: zuān/yíng
钻研: zuān/yán
钻空子: zuān/kòng/zi
钻床: zuàn/chuáng
钻戒: zuàn/jiè
钻塔: zuàn/tǎ
钻头: zuàn/tóu
钻石: zuàn/shí
电钻: diàn/zuàn
风钻: fēng/zuàn
作保: zuò/bǎo
作恶: zuò/è
作梗: zuò/gěng
作古: zuò/gǔ
作怪: zuò/guài
作假: zuò/jiǎ
作乐: zuò/yuè
作难: zuò/nán
作孽: zuò/niè
作呕: zuò/ǒu
作陪: zuò/péi
作祟: zuò/suì
作态: zuò/tài
作息: zuò/xī
作案: zuò/àn
作法: zuò/fǎ
作废: zuò/fèi
作风: zuò/fēng
作家: zuò/jiā
作品: zuò/pǐn
作为: zuò/wéi
作文: zuò/wén
作物: zuò/wù
作业: zuò/yè
作用: zuò/yòng
作战: zuò/zhàn
作者: zuò/zhě
作主: zuò/zhǔ
作弊: zuò/bì
作对: zuò/duì
作死: zuò/sǐ
作坊: zuō/fang
作弄: zuō/nòng
作揖: zuō/yī
做作: zuò/zuo
划拨: huà/bō
划策: huà/cè
划定: huà/dìng
划分: huà/fēn
划时代: huà/shí/dài
划拉: huá/lā
划拳: huá/quán
划算: huá/suàn
佰划: bǎi/huai
奇怪: qí/guài
奇数: jī/shù
奇数: jī/shù
